@@@@@@@@@@@@.@@@@@@@
@.@........@.......@
@.@.@@@@@@@@.@@@@@@@
@..................@
@@.@@@@@.@@@@@@@@@.@
@..@.....@...@.@@@.@
@@.@@@@@.@@@.@.....@
@........@@@.@.@@@.@
@@.@@@@@...@.@.@.@.@
@..@...@@@...@.@.@@@
@@.@@.@@.@.@.@.....@
@.....@@.@.@.@@.@@.@
@@.@@.@@.@.@.@@@@@.@
@@@@@@@@...@.@@....@
@.....@@.@@@.@@.@@@@
@.@@@.@@.@...@.....@
@.@.@.@@.@@@.@@@@@@@
@.@.@..............@
@...@.@@.@@@.@@.@@.@
@@@@@@@@@@@@@@@@@@.@