@.@@@@@@@@@@@@@@@@@@
@.@@.@.@....@......@
@....@...@@@@.@@@@.@
@@@@.@.@@@.@@..@@..@
@.@@.@...@..@@..@@.@
@......@@@.@@@.@@..@
@@@@.@..@@..@@.@@@.@
@@.@@@.@@@.@@....@.@
@....@.@.@..@@.@@@.@
@@.@.....@.@@...@@.@
@@@@@.@@......@@@@.@
@.@.@@@@@@@.@@@@...@
@..............@.@@@
@@@.@@@@@.@.@@.@@@@@
@...@.....@.@......@
@@@@@@@@@.@@@@.@.@@@
@@.@........@@.@...@
@....@@@@@.@@..@@.@@
@.@@....@@..@@.@...@
@@@@@@@@@@@@@@@@@@.@