@.@@@@@@@@@@@@@@@@@@
@.@.@.....@..@.....@
@.@.@@@.@...@@@@@.@@
@.@.....@@@@@.@@...@
@.@.@@@...@...@@.@@@
@.@@@.@@.@@.@@@@...@
@..@..@..@@....@.@@@
@@.@@.@.@@@.@.@@...@
@........@..@@@@.@@@
@@@@@@@@.@.@@@.@.@.@
@......@.@.@.......@
@@@@.@.@.@...@@@.@.@
@.@..@@@.@.@...@@@@@
@.@@.@.@...@.@.....@
@........@@@.@.@@.@@
@.@.@@.@@@@@@@..@..@
@@@@@@.....@@..@@@.@
@......@.@....@@.@@@
@.@.@.@@.@.@@......@
@@@@@@@@@@@@@@@@@@.@