@@@@@@@@@@@.@@@@@@@@
@.....@.....@...@.@@
@@@@@.@.@.@.@.@.@.@@
@.......@.@.@.@.@.@@
@@@@@@@.@.@.@.@.@..@
@.......@.@.@.@.@.@@
@.@@@@@@@.@.@.@.@.@@
@.......@.@.@.@.@.@@
@@@@@@@.@.@.@.@.@..@
@.......@.@.@.@.@.@@
@.@@@@@@@.@.@.@.@.@@
@.......@.@.@.@.@.@@
@@@@@@@@@.@...@...@@
@.@.@...@.@@@@@@@@@@
@.@.@.@.@...@...@.@@
@.@.@.@.@.@.@.@.@.@@
@.@.@.@.@.@.@.@.@.@@
@.@.@.@.@.@.@.@.@.@@
@.....@...@...@....@
@@@@@@@@@@@@@@@@@@.@