@.@@@@@@@@@@@@@@@@@@ 
@.@.@.@@.........@.@ 
@...@.@..@@@@@@@@@.@ 
@@@.@.@@...@@@.....@ 
@.@.@.@..@.....@@.@@ 
@.......@@@.@.@@...@ 
@@@@@@@.@.@@@@@@@@@@ 
@....@.............@ 
@@.@...@@.@@.@.@.@.@ 
@@@@@.@@...@@@@@@@@@ 
@@@@...@@.@@@.@.@..@ 
@@...@..@...@...@.@@ 
@..@.@.@@@.@.@@....@ 
@@.@@@...@@@.@@.@@.@ 
@...@@.@@@@@..@@@@.@
@.@..@.....@@..@...@ 
@@@@.@@.@.@@@@...@.@ 
@....@@.@@@@...@@@.@ 
@@.@.@.....@.@...@.@ 
@@@@@@@@@@@@@@@@@@.@