@.@@@@@@@@@@@@@@@@@@
@.@...........@....@
@.@.@.@@@@@@@@@@@@.@
@.@.@..............@
@...@@@@@@@@@@@@@@@@
@.@@@.@@...........@
@.@......@.@@@@@@@.@
@...@@@@@@.@.....@.@
@.@@@....@.@.@@@@@.@
@...@.@@.@.@.......@
@.@.@..@.@.@@@@@@@@@
@.@.@.@@.@.@....@@.@
@.@.@.@@.@...@@.@..@
@.@.@..@.@@@@@@...@@
@.@.@@@@......@@@.@@
@.@....@@@@@@......@
@.@@@@......@@@@@.@@
@.@.@.@@@@@@@.@....@
@...............@@.@
@@@@@@@@@@@@@@@@@@.@