@@@@@@@@@@@@@@@@@@.@
@.@@.@.@....@......@
@....@...@@@@.@@@@.@
@@@@.@.@@@.@@..@@..@
@.@@.@...@.@@@..@@.@
@......@@@.@@@.@@..@
@@@@.@..@@.@@@.@@@.@
@@.@@@.@@@.@@....@.@
@....@.@.@..@@.@@@.@
@@.@.....@.@@...@@.@
@@@@@.@@......@@@@.@
@.@@@@@@@@@.@@@@...@
@..............@.@@@
@@@.@@@@@.@.@@.@@@@@
@...@.....@.@......@
@@@@@@@@@.@@@@.@.@@@
@@@@........@@.@...@
@....@@@@@.@@..@@.@@
@.@@....@@..@@.@...@
@@@@@@@@@@@@@@@@@@.@