@.@@@@@@@@@@@@@@@@@@
@...@..@@..........@
@@@.@.@@..@@@@@@.@@@
@.@.@.@@.@@......@.@
@.@...@@.@@.@@@@@@.@
@.@.@@....@.@....@.@
@....@.@@@@.@@@@.@.@
@.@@...........@.@.@
@.@@@@@@@@@@.@.....@
@.@....@@@@..@@@.@@@
@.@.@@....@@@@@@@@@@
@...@@@@@@@@.......@
@.@@@@.@@@.@.@@.@@.@
@....@.......@@.@@.@
@.@@.@.@.@.@@@..@@.@
@.@@...@.@...@@....@
@@@@.@.@.@.@.@@.@@@@
@....@@@.@@@@@....@@
@.@@.@@......@@.@..@
@@@@@@@@@@@@@@@@@@.@