@@@@@@@@@@@@@@@@.@@@ 
@.@.@.@@.........@.@ 
@...@.@..@@@@@@@@@.@ 
@@@.@.@@...@@@.....@ 
@.@.@.@..@.....@@.@@ 
@.......@@@.@.@@...@ 
@@@@@@@.@.@@@@@@@@@@ 
@....@.............@ 
@@.@...@@.@@.@.@.@.@ 
@@@@@.@@...@@@@@@@@@ 
@@@@...@@.@@@.@....@ 
@@...@..@.......@@@@ 
@..@.@.@@@.@.@@....@ 
@@.@@@...@@@.@@.@@.@ 
@...@@.@@@@@..@@@@@@
@.@..@.....@@..@...@ 
@@@@.@@.@.@@@@...@.@ 
@....@@.@@@@...@@@.@ 
@@.@.@.....@.@...@@@ 
@@@@@@@@@@@@@@@@@@.@