@.@@@@@@@@@@@@@@@@@@
@.@........@.......@
@.@.@@@@@@@@.@@@@@@@
@..................@
@@.@@@@@.@@@@@@@@@.@
@..@.....@@....@@@.@
@@.@@@@@.@@@@@.....@
@.....@@.@@@.@.@@@.@
@@.@@@@@...@.@.@.@.@
@..@...@@@.@.@.@.@@@
@@.@@.@@.@.@.@.....@
@.....@@.@.@.@@.@@.@
@@.@@.@@.@.@.@@@@@.@
@@@@@@@@...@.@@....@
@.....@@.@@@.@@.@@@@
@.@@@.@@.@.........@
@.@.@.@@.@@@@@@@@@@@
@.@.@..............@
@...@.@@.@@@.@@.@@.@
@@@@@@@@@@@@@@@@@@.@